7 8 2
7 6 1
1 1 6 0 -1 -1 -1 -1 -1 -1 -1 -1 0 7 1 1
1 1 0 -1 -1 -1 1 1 1 1 -1 -1 -1 0 1 1
4 0 -1 -1 1 1 1 1 1 1 1 1 -1 -1 0 4
0 -1 -1 1 1 1 1 1 1 1 1 0 1 -1 -1 0
-1 -1 1 1 0 0 0 0 0 4 1 0 1 1 -1 -1
-1 -1 1 1 0 0 0 0 0 0 1 0 1 1 -1 -1
-1 1 1 1 0 1 1 0 0 0 1 0 1 1 1 -1
-1 1 1 1 0 1 0 0 0 0 1 0 1 1 1 -1
-1 1 1 1 0 1 0 0 0 0 1 0 1 1 1 -1
-1 1 1 1 0 1 1 1 1 1 1 0 1 1 1 -1
-1 -1 1 1 0 0 0 0 0 0 0 0 1 1 -1 -1
-1 -1 1 1 0 0 0 0 0 0 0 0 1 1 -1 -1
0 -1 -1 1 1 1 1 1 1 1 1 1 1 -1 -1 0
5 0 -1 -1 1 1 1 1 1 1 1 1 -1 -1 0 5
1 1 0 -1 -1 -1 1 1 1 1 -1 -1 -1 0 1 1
1 1 6 0 -1 -1 -1 -1 -1 -1 -1 -1 0 7 1 1

0 0 0 0 0 0 0 0 0 0 0 0 0 0 0 0
0 0 0 0 0 0 0 0 0 0 0 0 0 0 0 0
0 0 0 0 0 0 0 0 0 0 0 0 0 0 0 0
0 0 0 0 0 0 0 0 0 0 0 1 0 0 0 0
0 0 0 0 0 0 0 0 0 0 0 0 0 0 0 0
0 0 0 0 0 0 0 0 0 0 0 0 0 0 0 0
0 0 0 0 0 0 2 0 0 0 0 0 0 0 0 0
0 0 0 0 0 0 0 0 0 3 0 0 0 0 0 0
0 0 0 0 0 0 6 0 0 0 0 0 0 0 0 0
0 0 0 0 0 0 0 0 0 0 0 0 0 0 0 0
0 0 0 0 0 0 0 0 0 0 0 0 0 0 0 0
0 0 0 0 0 0 0 0 0 0 0 0 0 0 0 0
0 0 0 0 0 0 0 0 0 0 0 0 0 0 0 0
0 0 0 0 0 0 0 0 0 0 0 0 0 0 0 0
0 0 0 0 0 0 0 0 0 0 0 0 0 0 0 0
0 0 0 0 0 0 0 0 0 0 0 0 0 0 0 0